111111111111111111111111111111111111111111111111
100000100000000000000000111111100000000000000001
100000111111000000000010000000000000000000000001
100000000001000000000010111111100000000000000001
100000111101000000111110111110100000000000000001
100000100101000000100000000010100000000000000001
111111100101000000101111111010100000000000000001
100000000101000000101111111010100000000000000001
100000000101000000101111111010100000000000000001
100000000101000000101111111010100000000000000001
100000111101111110101111111011111111111101001111
100000100000000010101111111011000000000001000000
100000100000000010101111111011000111111101000000
100000100000000011101111111011000111111101111111
100000100000000000000011111011111110000000000001
100000100000000011111011111011111110000000000001
100000111111111111111011111011111110000000000001
100000000000000111111000000000000000000000000001
100000000000000000000000111111100000000000000001
100000000000000111000000100000000000000000000001
111111111111111111111111111111111111111111111111